

    | |                   | |        | |        | |                   | |        | |        | |    
 ***___***  *********  ***___***  ***___***  ***___***  *********  ***___***  ***___***  ***___*** 
 *      5*  *      2*  *      4*  *     10*  *      0*  *      1*  *      7*  *      3*  *      6* 
=|       |==|   E   * =|   P   * =|   M   |==|       |= *       |==|       |= *   V   |= *   I   * 
 *       *  *       *  *       *  *       *  *       *  *       *  *       *  *       *  *       * 
 *********  ***___***  *********  *********  ***___***  ***___***  *********  ***___***  ***___*** 
               | |                              | |        | |                   | |        | |    
